0000000000
0000000000
0000000000
0100000000
0000000000
0010000000
0000001000
0000000000
0000000000
1111111111